6 6
3 3 2 1 h
1 1 2 1 h
3 1 1 2 v
3 2 1 2 v
6 1 2 1 h
2 5 2 1 h
3 5 1 2 v
3 6 1 2 v
5 5 2 1 h
1 3 1 2 v