6 6
3 2 2 1 h
4 2 2 1 h
5 2 1 2 v
3 4 1 3 v
6 3 2 1 h
4 6 1 3 v