6 6
3 1 2 1 h
1 1 1 2 v
4 1 3 1 h
6 1 2 1 h
5 3 1 2 v
1 4 3 1 h
2 4 1 2 v
3 5 1 2 v
2 6 1 3 v
5 5 2 1 h
6 4 2 1 h