6 6
3 4 2 1 h
1 1 2 1 h
1 3 2 1 h
4 1 1 3 v
3 2 1 2 v
2 3 1 2 v
6 2 2 1 h
4 4 2 1 h
1 5 1 2 v
2 6 1 3 v
5 5 2 1 h
6 5 2 1 h