6 6
3 4 2 1 h
1 1 2 1 h
2 1 1 2 v
3 2 1 2 v
6 1 2 1 h
3 3 1 3 v
1 5 1 2 v
1 6 1 3 v
4 4 3 1 h