6 6
3 2 2 1 h
1 1 2 1 h
2 1 1 3 v
4 6 1 3 v
2 4 1 3 v
1 6 1 3 v
6 3 3 1 h
5 1 1 2 v