6 6 
3 2 2 1 h
1 2 1 2 v
1 3 2 1 h
2 4 1 2 v
4 3 2 1 h
5 4 1 2 v
1 5 1 2 v
1 6 1 2 v
3 6 1 2 v