6 6
3 1 2 1 h
1 1 1 2 v
1 2 2 1 h
2 3 1 3 v
6 1 3 1 h
1 6 1 3 v
4 4 3 1 h
5 5 1 2 v